111111111111111111111111111111111111111111111111111111111111
1P000000C000111111111111110000000000000C00000000000000000001
111110000000000000000000011111110000000000000000000000000001
100011000000000000000000000000011000000000000000000000000001
100000000000011111000000000000000000000000011111110000000001
100000000000000000000000000000000000000000000000011000000001
100000000000000000000000000000000000000000000000000000000001
100000000000000000000000000000000000000000000000000000000001
111110000000000000000000000000000000000000000000000000000001
100011111000000000000000000000000000000000000000000000000001
100000000000000000000000000000000000000000000000000000000001
100000000000000000000000000000000000000000000000000000000001
100000000000000000000000000000000000000000000000000000000001
100000000000000000000000000000000000000000000000000000000001
100000000000000000000000000000000000000000000000000000000001
100000000000000000000000000000000000000000000000000000000001
100000000000000000000000000000000000000000000000000000000001
100000000000000000000000000000000000000000000000000000000001
100000000000000000000000000000000000000000000000000000000001
100000000000000000000000000000000000000000000000000000000001
100000000000000000000000000000000000000000000000000000000001
100000000000000000000000000000000000000000000000000000000001
100000000000000000000000000000000000000000000000000000000001
100000000000000000000000000000000000000000000000000000000001
111110000000000000000000000000000000000000000000000000000001
100011111000000000000000000000000000000000000000000000000001
100000000000000000000000000000000000000000000000000000000001
100000000000000000000000000000000000000000000000000000000001
100000000000000000000C00000000000000000000000000000000000001
100000000000000000000000000000000000000000000000000000000E11
111111111111111111111111111111111111111111111111111111111111
