1111111111111111111111111111111111111111111111111111111111111
1C000000C0000000000000000000000000000000000000000000000000001
11111111111111111100000000000000C0000000000000000000000000E01
1P00000000000000000000000000000000000000000000000000000000001
1111111111111111111111111111111111111111111111111111111111111
