1111111111
1P10C010E1
1010101011
1000100011
1111111111
